F 165,185,200
C 240,230,235
NO xpm/play1.xpm
SO xpm/play2.xpm
WE xpm/play3.xpm
EA xpm/play4.xpm

1111111111111111111111111111111111111111111
         10N0000000110000000000001
         1011000001110100000000001
         100100000000000000000000111111
1111111110110000011111111111111111111111111
100000000011000001110111110111011111111111111
111101111111110111000000100011111111111111011
111101111111110111010100100000000000000000001
110000001101010111000000100011111111100000011
10000000000000001100000010001111111111111111
11111111111111111111111111111