NO xpm/wall1.xpm
SO xpm/wall_2.xpm
WE xpm/wall_3.xpm
EA xpm/wall4.xpm

F 220,100,0
C 225,30,0

  1111 1111  
 10000100001 
1000001010001
 11000000011 
100000100N001
111111111111