NO xpm/4K.xpm
SO xpm/4K.xpm
WE xpm/4K.xpm
EA xpm/4K.xpm


F 15,15,14
C 30,15,0

111111
100001
100001
100001
100001
100001
100001
100001
10E001
100001
100001
100001
 100001
  100001
   100001
    100001
     100001                     1111111
      100001                    1000001
      100001                    100001
       100001111111111111111111100001
        1000000000000000000000000001
         10000000000000000000000001
          100000000000000000000001
           1000000000000000000001
            10000000000000000001
             100001111111111111
            100001
           100001
          100001
        1100001
      11000011
    11000011
  11000011
11000011
100001
100001
100001
100001
100001
100001
100001
100001
100001
100001
100001
100001
 100001
  100001
   100001
    100001
     100001                     1111111
      100001                    1000001
      100001                    100001
       100001111111111111111111100001
        1000000000000000000000000001
         10000000000000000000000001
          100000000000000000000001
           1000000000000000000001
            10000000000000000001
             100001111111111111
            100001
           100001
          100001
        1100001
      11000011
    11000011
  11000011
11000011
100001
100001
10000111111111111111111111111111111111111111111111111111111111111111111111111111111111111111111111111111111111111111111111111111111111111111111111111111111111111111111111111111111111111111111111111111111111111111111111111111111111111111111111111111111111111111111
100000000000000000000000000000000000000000000000000000000000000000000000000000000000000000000000000000000000000000000000000000000000000000000000000000000000000000000000000000000000000000000000000000000000000000000000000000000000000000000000000000000000000000000001
100000000000000000000000000000000000000000000000000000000000000000000000000000000000000000000000000000000000000000000000000000000000000000000000000000000000000000000000000000000000000000000000000000000000000000000000000000000000000000000000000000000000000000000001
10000111111111111111111111111111111111111111111111111111111111111111111111111111111111111111111111111111111111111111111111111111111111111111111111111111111111111111111111111111111111111111111111111111111111111111111111111111111111111111111111111111111111111111111
100001
100001
100001
100001
100001
100001
 100001
  100001
   100001
    100001
     100001                     1111111
      100001                    1000001
      100001                    100001
       100001111111111111111111100001
        1000000000000000000000000001
         10000000000000000000000001
          100000000000000000000001
           1000000000000000000001
            10000000000000000001
             100001111111111111
            100001
           100001
          100001
        1100001
      11000011
    11000011
  11000011
11000011
100001
100001
100001
100001
 100001
  100001
   100001
    100001
     100001                     1111111
      100001                    1000001
      100001                    100001
       100001111111111111111111100001
        1000000000000000000000000001
         10000000000000000000000001
          100000000000000000000001
           1000000000000000000001
            10000000000000000001
             100001111111111111
            100001
           100001
          100001
        1100001
      11000011
    11000011
  11000011
11000011
100001
100001
100001
100001
 100001
  100001
   100001
    100001
     100001                     1111111
      100001                    1000001
      100001                    100001
       100001111111111111111111100001
        1000000000000000000000000001
         10000000000000000000000001
          100000000000000000000001
           1000000000000000000001
            10000000000000000001
             100001111111111111
            100001
           100001
          100001
        1100001
      11000011
    11000011
  11000011
11000011
100001
100001
100001
100001
 100001
  100001
   100001
    100001
     100001                     1111111
      100001                    1000001
      100001                    100001
       100001111111111111111111100001
        1000000000000000000000000001
         10000000000000000000000001
          100000000000000000000001
           1000000000000000000001
            10000000000000000001
             100001111111111111
            100001
           100001
          100001
        1100001
      11000011
    11000011
  11000011
11000011
100001
100001
100001
 100001
  100001
   100001
    100001
     100001                     1111111
      100001                    1000001
      100001                    100001
       100001111111111111111111100001
        1000000000000000000000000001
         10000000000000000000000001
          100000000000000000000001
           1000000000000000000001
            10000000000000000001
             100001111111111111
              1111